:SWORD II: ADVENTURE OF FROG
:arrow keys + X/C
:stick + A/X
000000000000000000000000000000
000000000000000000000000000000
000000000000000000000000000000
000000000000000000000000000000
00000000000000T000000000000000
000000000000000000000000000000
0000000000000000000000000000##
GG0000000000000000000000000###
GG-0000###00000000000000000###
GG00000###000000000000000BB###
GG-0000####000000000000--11111
GGgggg0####P0gg000gg00###11111
GGGGGGGGG11111GGGGGGGGGGGGGGGG
GGGGGGGGG11111GGGGGGGGGGGGGGGG
GGGGGGGGGGGGGGGGGGGGGGGGGGGGGG
GGGGGGGGGGGGGGGGGGGGGGGGGGGGGG
GGGGGGGGGGGGGGGGGGGGGGGGGGGGGG
