000000000000000011111111111111
000000000000000011111111111111
000000000000000011111111111111
000000000000000011111111111111
000000000000000011111111111111
000000000000000011111111111111
00000000000000001############1
00000000000000000###00##00####
0000000000000000S###00##00####
000000000000001111##11##11##11
0000000000g0111111##11##11##11
000000000011111111##11##11#011
0P000gg01111111111##11##110011
111111111111111111##11##110#11
111111111111111111##11##110#11
GGGGGGGG1111111111#011##11##11
GGGGGGGG11111111110011##11##11
