111111111111111111111111111111
111111111111111111111111111111
111111111111111111111111111111
111111111111111111111111111111
111111111111111111111111111111
111111111111111111111111111111
1############################1
00##00##00##00##00##00##00##00
0P##00##00##00##b0##b0##b0##00
111------------------------111
111000000000000000000000000111
110000000000000000000000000011
110000000000000000000000000011
11#000000000000000000000000#11
11##0000000000000000000000##11
11##0000000000000000000000##11
11##0000000000000000000000##11
