111111111111111111111111111111
111111111111111111111111111111
1111#######11####11#######1111
111########################111
111########################111
111#####00####00####00#####111
111####0000##0000##0000####111
#######0000##0000##0000####111
#C#####0000##0000##0000####111
111####0000##0000##0000####111
111####0000##0000##0000####111
111####0000##0000##0000#######
111####00P0##0F00##0000#####D#
1111111----11----11----1111111
1111111wwww11wwww11wwww1111111
1111111wwww11wwww11wwww1111111
1111111wwww11wwww11wwww1111111
