:YOU SAVED POND
:AND YOU ARE
:A REAL HERO
111000000000000000000000000000
111000000000000000000000000000
111000000000000000000000000000
111000000000000000000000000000
111000000000000000000000000000
1110000000000000T0000000000000
111000000000000000000000000000
111000000000000000000000000000
111000000000000000000000000000
111000000000000000000000000000
111000000000000000000000000000
###000000000000000000000000000
###0P0000000000000000000000000
1111111---11GG----------------
1111111www11GGwwwwwwwwwwwwwwww
11111wwwwwwGGGwwwwwwwwwwwwwwww
11111wwwwwwwGGGwwwwwwwwwwwwwww
