000000000000000000000000000000
000000000000000000000000000000
000000000000000000000000000000
000000000000000000000000000000
000000000000000000000000000000
000000000000000000000000000000
##0000000110000000000000000000
###00000#110000000000000000000
####00#####00000000####0000000
##P######000000000#######00000
111111#00000000000##00###00000
111111#ggBB00ggg0g##gg#S#ggg00
GGGG1111GGGGGGGGG111111111GGGG
GGGG1111GGGGGGGGG111111111GGGG
GGGGGGGGGGGGGGGGGGGGGGGGGGGGGG
GGGGGGGGGGGGGGGGGGGGGGGGGGGGGG
GGGGGGGGGGGGGGGGGGGGGGGGGGGGGG
