000000000000000000000000000000
000000000000000000000000000000
000000000000000000000000000000
000000000000000000000000000000
000000000000000000000000000000
000000000000000000000000000000
000000000000000gS00000000S0000
000000000000000110000000110000
00000000000000#11#00000011#000
00000000000000######0000###000
0000000000110##0####0000###000
000P00ggg1110#gBB###0ggBB##gg0
GGGGGGGGG111G1111GG111GGGGGGGG
GGGGGGGGG111G111GGGG11GGGGGGGG
GGGGGGGGG11111GGGGGGGGGGGGGGGG
GGGGGGGGGGGGGGGGGGGGGGGGGGGGGG
GGGGGGGGGGGGGGGGGGGGGGGGGGGGGG
