000000000000000000000000000000
000000000000000000000000000000
000000000000000000000000000000
000000000000000000000000000000
000000000000000000000000000000
000000000000000000000000000000
000000000000000gS00000000S0000
000000000000000110000000110000
00000000000000#11#00000011#000
00000000000000######0000###000
0000000000000##0####0000###000
000P00ggg0000#gBB###0ggBB##gg0
GGGGGGGGGGGGG1111GG111GGGGGGGG
GGGGGGGGGGGGG111GGGG11GGGGGGGG
GGGGGGGGGGGGG1GGGGGGGGGGGGGGGG
GGGGGGGGGGGGGGGGGGGGGGGGGGGGGG
GGGGGGGGGGGGGGGGGGGGGGGGGGGGGG
