GGGGG11111111111111111111GGGGG
GGGGG1111111111111111111111GGG
GGGGG11###00#############11GGG
GG11111##0000############11GGG
GG1111##0000##000########111GG
11111####0000#00000##0###11111
1111#####000000000000M####1111
0000####000000#0000000###00000
0P000##000000###0000M00###D000
1111111000011####1100001111111
1111111##0#11####11#0001111111
GGGGG11################11GGGGG
GGGGG11##0000000##00###11GGGGG
GGGGG1100000000000000##11GGGGG
GGGGG11000000000000000011GGGGG
GGGGG11000000000000000011GGGGG
GGGGG11000000000000000011GGGGG
