GGGGG1111111111111111111111111
GGG111111111111111111111111111
G111111###00##############0000
111######00000############0000
11######000000000########00000
11##000000000000000##000000000
1100000000000000000##000000000
0000000000000000000##000000000
0P00000000000000000##00BB00000
1111100000000000000##001111111
1111100000BB0000000##001111111
GGG11001111100000001100#####11
GGG11001111100000001100#####11
GGG11000###0000110000000####11
GGG11000###000011000000000##11
GGG11000###0000##00000000###11
GGG11000###0000##00000000###11
