111111111111111111111111111111
111111111111111111111111111111
0000##############00#######000
0000############00000####00000
0000000####0000000000000000011
00000000###000000000000000S011
00000000###0000000000000011111
00000000#110000000000BB1111111
0P00000BB110000000b00111111111
11111111111GGGGGG1111111111111
11111111111GGGGGGG111111111111
11GGGGGGGGGGGGGGGGGG1111GGGGGG
11GGGGGGGGGGGGGGGGGGGGGGGGGGGG
11GGGGGGGGGGGGGGGGGGGGGGGGGGGG
11GGGGGGGGGGGGGGGGGGGGGGGGGGGG
11GGGGGGGGGGGGGGGGGGGGGGGGGGGG
11GGGGGGGGGGGGGGGGGGGGGGGGGGGG
