000000000000000000000000000000
00M000000000000000000000000000
00000000000000000000000000M000
000000000000000000000000000000
000000000000000000000000000000
000000M00000000000000000000000
000000000000000000000000000000
000000000000000000000000000000
000000000000000000000000M00000
00000000000###0000000000000000
00000000000####0000##000000000
00000000000####0000##000000000
00000###000######gg##g##00##00
000######11111111GG11111111111
gP#######1111111GGGG1111111111
111----1111GGGGGGGGGGGGGGGGGGG
11100001111GGGGGGGGGGGGGGGGGGG
