000000000000000000000000000000
000000000000000000000000000000
000000000000000000000000000000
000000000000000000000000000000
000000000000000000000000000000
00000000000000000000000BBB##00
00000000000000000000000111##00
00000000000000000000000111#000
000000000000000000000001110000
00000000000000000M0000#1110000
00000##00000000000000##111#000
0000###000000000##00M######000
0P00###g0bgg000###BBB###D##000
1111111GGGGGGGGG11111111111111
1111111GGGGGGGGGG1111111111111
GGGGGGGGGGGGGGGGGGGGGGGGGGGGGG
GGGGGGGGGGGGGGGGGGGGGGGGGGGGGG
